15 15
###############
#             #
############# #
##### #   # # #
# # # # # # # #
# # # # # # # #
# # # # # # # #
# #   # #     #
# ##### #######
# #   #       #
# # # ####### #
#   #       # #
########### # #
#             #
###############