15 15
###############
#             #
##### ####### #
#   # #   # # #
# # # # # # # #
# # # # # # # #
# # # # # # # #
# #   # #   # #
# ##### #######
# #   #       #
# # # ####### #
#   #       # #
###G####### # #
# SP          #
###############
